11111111111111111111111111
1P00000100000000000010C001
1E000001000000010000100001
1C000000000000000010000001
11111111111111111111111111